0	0	0	0	0	0	0	0	0	0	0	0	0	
0	1	0	1	0	1	0	1	0	1	0	1	0	
0	1	0	1	0	1	0	1	0	1	0	1	0	
0	1	0	1	0	1	2	1	0	1	0	1	0	
0	1	0	1	0	3	0	3	0	1	0	1	0	
0	3	0	3	0	4	0	4	0	3	0	3	0	
4	0	4	4	0	3	0	3	0	4	4	0	4	
5	0	3	3	0	4	0	4	0	3	3	0	5	
0	4	0	4	0	1	1	1	0	4	0	4	0	
0	1	0	1	0	1	0	1	0	1	0	1	0	
0	1	0	1	0	3	0	3	0	1	0	1	0	
0	1	0	1	0	6	4	7	0	1	0	1	0	
0	0	0	0	0	8	9	10	0	0	0	0	0

